#**********#
#**1*******#
#**********#
#**********#
#**********#
############
