###**************###
###***********#**###
###**************###
###*****#********###
###**************###
###**************###
###**************###
###****#*****#***###
###*********1****###
###************#####
###**************###
####################
####################
