#***********************************************************************************************************************************************************************************************************************************#
#*************************************************************************************************************************************************************************************************************###**#**##**#***#*#***#
#*************************#*********************************************************************************************************************************************************************##************#****#**#*#*#*********#
#***********************************************************************************########***####**************#***********###****####*******************************************************###************###**#**#**##**#***#**#
#*********************************************************************************************************************************************************************************************####************#****#**#***#***###***#
#********************************************************************************************************************************************************************************************######*********************************#
#*******************#***#####*********************##*********##******************###**************#*****##****#**#**#*****#**********##******#**#**********##**#************####************######**********************************#
#*****************************************##******##*********##*****************************************************************************##**##********###**##**************************#######**********************************#
#*******************************##********##******##*********##****************************************************************************###**###******####**###*****##**************##*########**********************************#
#****1**************************##********##******##*********##***************************************************************************####**####****#####**####****##**************###########********#*************************#
#########################################################################**###############***################################################################**######################################################################
#########################################################################**###############***################################################################**######################################################################
*************************************************************************************************************************************************************************************************************************************
*************************************************************************************************************************************************************************************************************************************
********************************************************************************************************************************************************#***#######****##************************************************************
********************************************************************************************************************************************************#***#######****##************************************************************
********************************************************************************************************************************************************#**************##************************************************************
********************************************************************************************************************************************************#**************##************************************************************
********************************************************************************************************************************************************#**************##************************************************************
********************************************************************************************************************************************************#**************##************************************************************
********************************************************************************************************************************************************#**************##************************************************************
********************************************************************************************************************************************************#**************##************************************************************
********************************************************************************************************************************************************#**************##************************************************************
********************************************************************************************************************************************************#***#######****##************************************************************
********************************************************************************************************************************************************#***#######**####************************************************************
********************************************************************************************************************************************************#***#######**####************************************************************
********************************************************************************************************************************************************#################************************************************************
********************************************************************************************************************************************************#################************************************************************
